HW HW HW HW HW HW HW HW HW HW HW
HW EW EW EW EW EW EW EW EW EW HW
HW EW HW EW HW SW HW EW HW EW HW
HW SW EW EW EW EW EW EW EW EW HW
HW EW HW EW HW EW HW EW HW EW HW
HW SW EW SW EW EW EW EW EW EW HW
HW EW HW SW HW EW HW EW HW SW HW
HW EW EW EW EW SW EW EW EW EW HW
HW EW HW EW HW EW HW EW HW EW HW
HW SW EW EW EW EW EW EW SW EW HW
HW HW HW HW HW HW HW HW HW HW HW