HW HW HW HW HW HW HW HW HW HW HW
HW EW EW EW EW EW EW EW EW EW HW
HW EW HW EW HW EW HW EW HW EW HW
HW EW EW EW EW EW EW EW EW EW HW
HW EW HW EW HW EW HW EW HW EW HW
HW EW EW EW EW EW EW EW EW EW HW
HW EW HW EW HW EW HW EW HW EW HW
HW EW EW EW EW EW EW EW EW EW HW
HW EW HW EW HW EW HW EW HW EW HW
HW EW EW EW EW EW EW EW EW EW HW
HW HW HW HW HW HW HW HW HW HW HW